10 20
____________________
|...#..|........|.#|
|.F.|...|...|...|..|
|____..F.|..|.F#|..|
|...|.......|___|..|
|...|...F..........|
|@....#..|......F..|
|________|......___|
|..F....F.......#..|
|__________________|
